111111
1P00E1
110111
101C01
111111
