111111
1P00C1
101111
1C01E1
111111
