111111
1P01E1
110011
1C00C1
111111
